湿	干	ANT
日	夜	ANT
纬	经	ANT
凸	凹	ANT
籴	粜	ANT
贫	富	ANT
饿	饱	ANT
本	末	ANT
轻	重	ANT
低	高	ANT
静	动	ANT
旱	涝	ANT
竖	横	ANT
竖	横	ANT
终	始	ANT
广	狭	ANT
纵	横	ANT
香	臭	ANT
易	难	ANT
精	粗	ANT
去	来	ANT
短	长	ANT
荣	辱	ANT
优	劣	ANT
媸	妍	ANT
先	后	ANT
私	公	ANT
屈	伸	ANT
浮	沉	ANT
凹	凸	ANT
顺	逆	ANT
甜	苦	ANT
少	多	ANT
瘦	胖	ANT
牝	牡	ANT
小	大	ANT
下	上	ANT
恶	好	ANT
这	那	ANT
子	母	ANT
死	生	ANT
好	坏	ANT
韧	脆	ANT
仰	俯	ANT
缓	急	ANT
祸	福	ANT
文	质	ANT
苦	甘	ANT
赚	赔	ANT
卖	买	ANT
是	非	ANT
明	暗	ANT
妇	夫	ANT
退	进	ANT
详	略	ANT
正	歪	ANT
正	反	ANT
正	负	ANT
正	负	ANT
浓	淡	ANT
肥	瘦	ANT
肥	瘦	ANT
体	用	ANT
松	紧	ANT
素	荤	ANT
张	弛	ANT
张	松	ANT
厚	薄	ANT
双	单	ANT
左	右	ANT
此	彼	ANT
攻	守	ANT
慢	快	ANT
柔	刚	ANT
涝	旱	ANT
弊	利	ANT
重	轻	ANT
反	正	ANT
狭	广	ANT
无	有	ANT
新	旧	ANT
新	旧	ANT
远	近	ANT
牡	牝	ANT
西	东	ANT
深	浅	ANT
北	南	ANT
曲	直	ANT
高	低	ANT
前	后	ANT
细	粗	ANT
真	假	ANT
母	公	ANT
野	朝	ANT
众	寡	ANT
黑	白	ANT
贱	贵	ANT
稀	密	ANT
稀	稠	ANT
窄	宽	ANT
弱	强	ANT
弱	强	ANT
利	害	ANT
硬	软	ANT
奇	偶	ANT
奇	偶	ANT
惰	勤	ANT
热	冷	ANT
快	钝	ANT
淡	咸	ANT
夜	日	ANT
功	过	ANT
奇	偶	ANT
败	胜	ANT
雄	雌	ANT
古	今	ANT
咸	淡	ANT
闲	忙	ANT
阳	阴	ANT
锐	钝	ANT
福	祸	ANT
背	向	ANT
南	北	ANT
外	内	ANT
仆	主	ANT
仆	主	ANT
直	横	ANT
老	嫩	ANT
经	纬	ANT
负	正	ANT
负	正	ANT
褒	贬	ANT